XXXXXXXXXX
X        X
X  X X   X
X    X   X
XXXXXX   X
X        X
XXXXXXXXXX